11111111111111111111
1E0C0000001100000011
1P0000C00C00000C0001
101100C000CCCCC11001
1000111000CCCCC00001
1000E00000CCCCC00001
10000000000000000001
11111111111111111111
