111111111111
10000E000011
1110000P0C01
111111111111
