111111111111111111111111
100000000000C00000000001
10000000000CCC0000000001
100P000000CCCCC000000001
100000000CCCCCCC00000001
10000000C000000C00000001
100000CCCC0000CCCC000001
10000CCCCCC00CCCCCC00001
10E0CCCCCCCC0CCCCCCC0001
111111111111111111111111
