11111111111111
1CPE00i01111
11C C00P111
10000000111111111110011
111111111
