111111111111111111111111
100000000000C00000000001
10000000000CCC0000000001
1000000000CCCCC000000001
100P00000CCCCCCC00000001
10000000CCCCCCCCC0000001
1000000C00000000C0000001
100000CCC000000CCC000001
10000CCCCC0000CCCCC00001
10E0CCCCCCC00CCCCCCC0001
100CCCCCCCCCCCCCCCCCC001
111111111111111111111111
